111111111111111111111111111111111111111111111111111111111111
1E0000000C000000000G00011000000000000000000C0011111111111111
101001010010000010100101101001100100G00101001011111111111111
1010010010101010001001G1101001010101010001001G11111111111111
1000000000000C0000000001100000000001000000000011111111111111
100000000000000000000000000000000000C00000000011111111111111
1000000000000000000000C0000000000000000000000011111111111111
100000000C00000000000001100000000000001000GC0011111111111111
10100101001000C0101G0101101001010010000101001111111111111111
1010010010101010001001G1101001001010110001001111111111111111
1000000000000C0000000001100000000000100000000011111111111111
1000000000000C0000000001100000000000100000000011111111111111
1000000000000C0000000001100000000000100000000011111111111111
100000000C000000000G00011000000000000000000C0011111111111111
1010010100100000101001011010010100100G0010001011111111111111
1010010010101010001001G1101001001010101000101G11111111111111
1000000000000C0000000001100000000000100000000011111111111111
10000000000000P0000000000000000000000C0000000011111111111111
1000000000000000000000C0000000000000000000000011111111111111
100000000C000000000000011000000000000001000GC001111111111111
10100101001000C0101G0101101001010010000010100111111111111111
1010010010101010001001G1101001001010101000100111111111111111
1000000000000C0000000001100000000000100000000001111111111111
1000000000000C0000000001100000000000100000000001111111111111
1000000000000000000000000000000000000C0000000001111111111111
1000000000000000000000C0000000000000000000000011111111110111
100000000C000000000000011000000000000001000GC000000000000111
10100101001000C0101G0101101001010010000010100110000000000111
111111111111111111111111111111111111111111111111111111111111
111111111111111111111111111111111111111111111111111111111111
111111111111111111111111111111111111111111111111111111111111
111111111111111111111111111111111111111111111111111111111111
